0 0 0 0 0 0 0 0 0 0 0 0 0 0 0 0 0 0 0 0 0 0 0 0 0 0 0 0
0 1 1 1 1 1 1 1 1 1 1 1 1 0 0 1 1 1 1 1 1 1 1 1 1 1 1 0
0 1 0 0 0 0 1 0 0 0 0 0 1 0 0 1 0 0 0 0 0 1 0 0 0 0 1 0
0 2 0 3 3 0 1 0 3 3 3 0 1 0 0 1 0 3 3 3 0 1 0 3 3 0 2 0
0 1 0 0 0 0 1 0 0 0 0 0 1 0 0 1 0 0 0 0 0 1 0 0 0 0 1 0
0 1 1 1 1 1 1 1 1 1 1 1 1 1 1 1 1 1 1 1 1 1 1 1 1 1 1 0
0 1 0 0 0 0 1 0 0 1 0 0 0 0 0 0 0 0 1 0 0 1 0 0 0 0 1 0
0 1 0 0 0 0 1 0 0 1 0 0 0 0 0 0 0 0 1 0 0 1 0 0 0 0 1 0
0 1 1 1 1 1 1 0 0 1 1 1 1 0 0 1 1 1 1 0 0 1 1 1 1 1 1 0
0 0 0 0 0 0 1 0 0 0 0 0 3 0 0 3 0 0 0 0 0 1 0 0 0 0 0 0
3 3 3 3 3 0 1 0 0 0 0 0 3 0 0 3 0 0 0 0 0 1 0 3 3 3 3 3
3 3 3 3 3 0 1 0 0 3 3 3 3 3 3 3 3 3 3 0 0 1 0 3 3 3 3 3
3 3 3 3 3 0 1 0 0 3 0 0 0 3 3 0 0 0 3 0 0 1 0 3 3 3 3 3
0 0 0 0 0 0 1 0 0 3 0 3 3 3 3 3 3 0 3 0 0 1 0 0 0 0 0 0
4 4 4 4 4 4 1 3 3 3 0 3 6 7 8 9 3 0 3 3 3 1 4 4 4 4 4 4
0 0 0 0 0 0 1 0 0 3 0 3 3 3 3 3 3 0 3 0 0 1 0 0 0 0 0 0
3 3 3 3 3 0 1 0 0 3 0 0 0 0 0 0 0 0 3 0 0 1 0 3 3 3 3 3
3 3 3 3 3 0 1 0 0 3 3 3 3 3 3 3 3 3 3 0 0 1 0 3 3 3 3 3
3 3 3 3 3 0 1 0 0 3 0 0 0 0 0 0 0 0 3 0 0 1 0 3 3 3 3 3
0 0 0 0 0 0 1 0 0 3 0 0 0 0 0 0 0 0 3 0 0 1 0 0 0 0 0 0
0 1 1 1 1 1 1 1 1 1 1 1 1 0 0 1 1 1 1 1 1 1 1 1 1 1 1 0
0 1 0 0 0 0 1 0 0 0 0 0 1 0 0 1 0 0 0 0 0 1 0 0 0 0 1 0
0 1 0 0 0 0 1 0 0 0 0 0 1 0 0 1 0 0 0 0 0 1 0 0 0 0 1 0
0 2 1 1 0 0 1 1 1 1 1 1 1 3 5 1 1 1 1 1 1 1 0 0 1 1 2 0
0 0 0 1 0 0 1 0 0 1 0 0 0 0 0 0 0 0 1 0 0 1 0 0 1 0 0 0
0 0 0 1 0 0 1 0 0 1 0 0 0 0 0 0 0 0 1 0 0 1 0 0 1 0 0 0
0 1 1 1 1 1 1 0 0 1 1 1 1 0 0 1 1 1 1 0 0 1 1 1 1 1 1 0
0 1 0 0 0 0 0 0 0 0 0 0 1 0 0 1 0 0 0 0 0 0 0 0 0 0 1 0
0 1 0 0 0 0 0 0 0 0 0 0 1 0 0 1 0 0 0 0 0 0 0 0 0 0 1 0
0 1 1 1 1 1 1 1 1 1 1 1 1 1 1 1 1 1 1 1 1 1 1 1 1 1 1 0
0 0 0 0 0 0 0 0 0 0 0 0 0 0 0 0 0 0 0 0 0 0 0 0 0 0 0 0