0 0 0 0 0 0 0 0 0 0 0 0 0 0 0 0 0 0 0 0 0 0 0 0 0 4 0 0 0 0 0 0 0 0 0 0 0 0 0 0 0 0 0 0 0 0 0 0 0 0 0
0 1 1 1 1 1 1 1 1 1 1 1 1 1 1 1 1 1 1 1 1 0 3 3 0 4 0 3 3 0 1 1 1 1 1 1 1 1 1 1 1 1 1 1 1 1 1 1 1 1 0
0 1 0 0 0 0 0 1 0 0 0 0 0 0 0 0 0 0 0 0 1 0 3 3 0 4 0 3 3 0 1 0 0 0 0 0 0 0 0 0 0 0 0 1 0 0 0 0 0 1 0
0 1 0 0 0 1 1 1 0 1 1 1 1 1 1 1 1 1 1 0 1 0 3 3 0 4 0 3 3 0 1 0 1 1 1 1 1 1 1 1 1 1 0 1 1 1 0 0 0 1 0
0 1 1 0 0 1 0 0 0 1 0 0 0 0 0 0 0 0 1 0 1 0 0 0 0 4 0 0 0 0 1 0 1 0 0 0 0 0 0 0 0 1 0 0 0 1 0 0 1 1 0
0 0 1 1 0 1 0 0 0 1 0 0 0 0 3 3 3 0 1 0 1 1 1 1 1 1 1 1 1 1 1 0 1 0 3 3 3 0 0 0 0 1 0 0 0 1 0 1 1 0 0
0 0 0 1 0 1 1 1 0 1 1 1 1 0 3 3 3 0 1 0 0 0 0 0 0 1 0 0 0 0 0 0 1 0 3 3 3 0 1 1 1 1 0 1 1 1 0 1 0 0 0
0 1 1 1 0 0 0 1 0 0 0 0 1 0 3 3 3 0 1 1 1 1 0 3 0 1 0 3 0 1 1 1 1 0 3 3 3 0 1 0 0 0 0 1 0 0 0 1 1 1 0
0 1 0 0 0 0 0 1 1 1 1 0 1 0 0 0 0 0 0 0 0 1 0 3 0 1 0 3 0 1 0 0 0 0 0 0 0 0 1 0 1 1 1 1 0 0 0 0 0 1 0
0 1 0 0 0 0 0 0 0 0 1 0 1 1 1 1 1 1 1 2 0 1 0 3 0 1 0 3 0 1 0 2 1 1 1 1 1 1 1 0 1 0 0 0 0 0 0 0 0 1 0
0 1 1 1 1 1 0 3 3 0 1 0 0 0 0 0 0 0 0 0 0 1 0 3 0 1 0 3 0 1 0 0 0 0 0 0 0 0 0 0 1 0 3 3 0 1 1 1 1 1 0
0 0 0 0 0 1 0 3 3 0 1 1 1 1 1 1 1 1 1 1 1 1 0 0 0 1 0 0 0 1 1 1 1 1 1 1 1 1 1 1 1 0 3 3 0 1 0 0 0 0 0
0 3 3 3 0 1 0 3 3 0 0 0 0 0 0 0 0 0 0 0 0 1 1 1 1 1 1 1 1 1 0 0 0 0 0 0 0 0 0 0 0 0 3 3 0 1 0 3 3 3 0
0 3 3 3 0 1 0 3 3 3 3 3 3 3 3 3 3 3 3 3 0 0 1 0 0 1 0 0 1 0 0 3 3 3 3 3 3 3 3 3 3 3 3 3 0 1 0 3 3 3 0
0 0 0 0 0 1 0 0 0 0 0 0 0 0 0 0 0 0 0 0 0 0 1 0 3 3 3 0 1 0 0 0 0 0 0 0 0 0 0 0 0 0 0 0 0 1 0 0 0 0 0
4 4 4 4 4 6 1 1 1 1 1 1 1 1 1 1 1 1 1 1 1 1 1 1 3 2 3 1 1 1 1 1 1 1 1 1 1 1 1 1 1 1 1 1 1 5 4 4 4 4 4
0 0 0 0 0 1 0 0 0 0 0 0 0 0 0 0 0 0 0 0 0 0 1 0 3 3 3 0 1 0 0 0 0 0 0 0 0 0 0 0 0 0 0 0 0 1 0 0 0 0 0
0 3 3 3 0 1 0 3 3 3 3 3 3 3 3 3 3 3 3 3 0 0 1 0 0 1 0 0 1 0 0 3 3 3 3 3 3 3 3 3 3 3 3 3 0 1 0 3 3 3 0
0 3 3 3 0 1 0 3 3 0 0 0 0 0 0 0 0 0 0 0 0 1 1 1 1 1 1 1 1 1 0 0 0 0 0 0 0 0 0 0 0 0 3 3 0 1 0 3 3 3 0
0 0 0 0 0 1 0 3 3 0 1 1 1 1 1 1 1 1 1 1 1 1 0 0 0 1 0 0 0 1 1 1 1 1 1 1 1 1 1 1 1 0 3 3 0 1 0 0 0 0 0
0 1 1 1 1 1 0 3 3 0 1 0 0 0 0 0 0 0 0 0 0 1 0 3 0 1 0 3 0 1 0 0 0 0 0 0 0 0 0 0 1 0 3 3 0 1 1 1 1 1 0
0 1 0 0 0 0 0 0 0 0 1 0 1 1 1 1 1 0 0 0 0 1 0 3 0 1 0 3 0 1 0 0 0 0 1 1 1 1 1 0 1 0 0 0 0 0 0 0 0 1 0
0 1 0 0 0 0 0 1 1 1 1 0 1 0 0 0 1 0 1 1 1 1 0 3 0 1 0 3 0 1 1 1 1 0 1 0 0 0 1 0 1 1 1 1 0 0 0 0 0 1 0
0 1 1 1 0 0 0 1 0 0 0 0 1 0 2 0 1 0 1 0 0 0 0 0 0 1 0 0 0 0 0 0 1 0 1 0 2 0 1 0 0 0 0 1 0 0 0 1 1 1 0
0 0 0 1 0 1 1 1 0 1 1 1 1 0 1 1 1 0 1 0 1 1 1 1 1 1 1 1 1 1 1 0 1 0 1 1 1 0 1 1 1 1 0 1 1 1 0 1 0 0 0
0 1 1 1 0 1 0 0 0 1 0 0 0 0 0 0 0 0 1 0 1 0 0 0 0 4 0 0 0 0 1 0 1 0 0 0 0 0 0 0 0 1 0 0 0 1 0 1 1 1 0
0 1 0 0 0 1 1 1 0 1 1 1 1 1 1 1 1 1 1 0 1 0 3 3 0 4 0 3 3 0 1 0 1 1 1 1 1 1 1 1 1 1 0 1 1 1 0 0 0 1 0
0 1 0 0 0 0 0 1 0 0 0 0 0 0 0 0 0 0 0 0 1 0 3 3 0 4 0 3 3 0 1 0 0 0 0 0 0 0 0 0 0 0 0 1 0 0 0 0 0 1 0
0 1 1 1 1 1 1 1 1 1 1 1 1 1 1 1 1 1 1 1 1 0 3 3 0 4 0 3 3 0 1 1 1 1 1 1 1 1 1 1 1 1 1 1 1 1 1 1 1 1 0
0 0 0 0 0 0 0 0 0 0 0 0 0 0 0 0 0 0 0 0 0 0 0 0 0 4 0 0 0 0 0 0 0 0 0 0 0 0 0 0 0 0 0 0 0 0 0 0 0 0 0
0 0 0 0 0 0 0 0 0 0 0 0 0 0 0 0 0 0 0 0 0 0 0 0 0 4 0 0 0 0 0 0 0 0 0 0 0 0 0 0 0 0 0 0 0 0 0 0 0 0 0